index, North, South, West, East, ND, SD, WD, ED
    1,     2,      ,     ,     ,  2,   ,   ,   
    2,     3,     1,    5,     ,  2,  2,  2,   
    3,      ,     2,    6,     ,   ,  2,  2,   
    4,     5,      ,    7,     ,  2,   ,  2,   
    5,      ,     4,    8,    2,   ,  2,  2,  2
    6,      ,      ,    9,    3,   ,   ,  2,  2
    7,      ,      ,     ,    4,   ,   ,   ,  2
    8,      ,      ,   11,    5,   ,   ,  2,  2
    9,      ,      ,     ,    6,   ,   ,   ,  2
   10,    11,      ,     ,     ,  2,   ,   ,   
   11,    12,    10,     ,    8,  2,  2,   ,  2
   12,      ,    11,     ,     ,   ,  2,   ,   